EverGreen
GGWWWWWWGGGGTTTTGGGG
GGGWWWWWWWGGGTGGGSGG
GGWWWWWWGGGEGGGGGGGG
GGGGGWWWGGGGGGGGGGTG
GGCGWWWWGGGGGGGGGTTT
GGGGTTTGGGGGGEGGGGTT
GGGGGTTGGGGGGGGGGGGG
GGGGGTTGGGGGGGGGGGGG
GGEGGTTTGGGGGGTTGGGG
GGGGGGTGGGGGGGTTTGEG
GGGGGTTGGGGGGTTGGGGG
GGGGGGTGGGGWWWWGGGGG
GGGGGGTTGGGGWWWWGGCG
GGGGGGGEGGGWWWWWWWGG
GGGGGGGGGGGGGWWWWWWW
GGGGGGTGGGGWWWWWWGGG
GGEGGGTTGGGGWWWWGGGG
GGGGGTTTGGGGGGGGGGGG
GGGGGGCTTTGGGGGGBGGG
GGGGTTTTTTTGGGGGGGGG