Monster Fields
EGGGGGGGGGGGGGGGGGGG
GGGGTGGGGGGGEGGGGGGG
GGGGGGGCGGGGGGTGGGGG
GGGGGGGGGGGGGGGGGGGG
GGGGGGGGGSGGGGGGEGGG
WWWWGGGGGGGGGGCGGGGG
WWWWWWGGGGGGGGGGGGGG
GBGGGGGGGTGGGGGGGGGG
GGGGGGGGGEGGGGGGGGGG
GGGGGGEGGGGGWWWWWWWW
WWWWWGGGGWWWWWWWWGGG
GTWWWWWGGGGWWWWGGEGG
GGGGWWWGGGGGWWWWWGGG
GGGEGGWWGGGWWWWGGGGG
GGGGGGGGGGGGGGGGGGGG
GGGGGTTTTGGGTTTTTTTT
GGGCGTCGTGGGGGGGGGGG
TTTTTTGGTTTTTGGTTTGG
GGEGGGGGGTTGGGGGCTGG
GGGGEGGGGGGGGTTGTTGB