The Maze
GGTTTTGGGGGWWWWWWWWW
GSTGETTTGGWWCGGEGGWW
GGTGGTTCGGWWWWWWGGWG
GGGGGGTTTGGWWWGWGGGG
GGTTGGGGTGGGGGGGGGGW
GGTTTTGGTTGGTGGGGWWW
GEGGGGGGGTGTTGGGWWWW
GGTTGTTGGGGGGGEGGGGG
TGTGGTTGGTGGTTTTTTGG
GCTTEGTTTTTTTGGGGGGG
GGTTGGTGGTTTGGGGGGWW
GGTGGGTGGGGGGEGGGWWW
GGGGGGGGGGGGGGGGGWWW
GGTTTTTGTTTTTGTGGGCG
GGGTTTTGTTTGTGTTTTTT
GBGTTTTTTTEGGGGGGTTT
TTTTGGCGGTTTTGTGGTGG
GGGGGGGGGGGTGGTGGTGG
GGGGGGGGGGGGGGGGGGGG
GGGEGGGGGGBGGGGEGGGG